b00ww0ww0w00ww0
0w00000w0ww0w00
00ww0w000w0000w
w000wwww000ww0w
000w00000www00w
ww0wwww0ww000ww
w000ww0000ww0ww
00w00ww0w0ww000
w0w0w000w000www
00w00wwww0www00
www0ww0000ww00w
w000w00w0ww00ww
00ww00w00000www
w00w000w0ww0w0w
w000wwww00w000e